------------------------------------------------------------------------------------------------------------------------------------------------------------------------------------
----------------------------------------------xxxx----------------------------------------------------------------------------------------------------------------------------------
---------------------------------------------xx---x---------------------------------------------------------------------------------------------------------------------------------
--------------------------------------------xx-----x--------------------------------------------------------------------------------------------------------------------------------
-------------------------------------------xx-------x-----------xxxxx---------------------------------------------------------------------------------------------------------------
-----------------E------------------xxxxxxxx------E--xxxxxxxxxxxx----xxxxxxxxxxxxxx---------E---------------------------------------------------------------------------------------
--------------SSSSSSSSSSS----------xx?QQQQQQ---------SSSSSSSSSSSS----SSSSSSSSSSSSX-x------------E-----------------------?------------------------------------------------XX---------
----------------------------------xx---------------------------------------------X--x---E-------------------------------E-----------------------------------------------XXX---------
---------------------------------xx----------------------------------------------X---x-------------------------------------E-------------------------------------------XXXX---------
-------------------E-------xxxxxxx--------------------------E--------------------X--E-x-----------------------------------<>--------E--EE-----------------------------XXXXX---------
--------------SSSSSS?SSSS-xx--QQQ?---S---------------------<>------S------------?X-<>--x-----------------?QQ--------------[]-------<>--<>---------E------------------XXXXXX---------
-------------------------xx--------------------------------[]----------------E---X-[]---x-------------------------B-------[]---<>--[]--[]---------------------------XXXXXXX---------
------------------------xx---------------------------------[]---------------<>---X-[]----x---xxxxx---B------------b-------[]---[]--[]--[]--------------------------XXXXXXXX---------
----xxxxxxxxxxxxxxxxxxxxx-------------EE-------------------[]---------------[]---X-[]-E---xxxx----xxxxxxxxxxxxxxxxxxxxxxxx[]---[]--[]--[]-------------------------XXXXXXXXX--------X
XXXXxXXXXXXXXXXXXXXXXXXXX----XXXXXXXXXXXX--------XXXXXXXXXXXXXXXXX----------XXXXXXXXXXXXXXXXXX---XXXXXXXXXXXXXXXXXXXXXXXXXXX---XX--XXXXXXXXXXXXXXXX----XXX----XXXXXXXXXXXXXXXXXX---X
XXXXXXXXXXXXXXXXXXXXXXXXX----XXXXXXXXXXXX--------XXXXXXXXXXXXXXXXX----------XXXXXXXXXXXXXXXXXX---XXXXXXXXXXXXXXXXXXXXXXXXXXX---XX--XXXXXXXXXXXXXXXX----XXX----XXXXXXXXXXXXXXXXXX---X
