---------------------------------------------------------------------------------------------------------------------------------------------------------------
---------------------------------------------------------------------------------------------------------------------------------------------------------------
---------------------------------------------------------------------------------------------------------------------------------------------------------------
---------------------------------------------------------------------------------------------------------------------------------------------------------------
---SSSSSSSSS---------------------------------------------------------------------------------------------------------------------------------------------------
---------------------------------------------------------------------------------------------------------------------------------------------------------------
--------------XXX----------------------------------------------------------------------------------------------------------------------------------------------
----------------------------------------------------------------------------SSSSSSSSSSSSSSSSSSSSSSSSSSSSSSSSSSSSSSSSSSSSSSSSSSSSSSSSSSSSSSSSSSSSSSSSSSSSSSSS---
-------------------------------------------------------------------------E-------------------------------------------------------------------------------------
--------------------------------------------------------------xx--------<>-------------------------------------------------------------------------------------
---------xxxxx-----SSSSSSSS------------------------ooo-------xx-x-------[]-------------------------------------------------------------------------------------
--------xxXXX-xxxx------------------------S-------------xxxxxx---xxx---S[]S------------------------------------------------------------------------------------
-------xxEXXX-XXX-x------------------------------------xx---x----<>-x---XX-xxx---------------------------------------------------------------------------------
------xxXXXXX------x----------------xxx-----xxx-------xx----X----[]--x----xx--x--------------------------------------------------------------------------xxxxx-
-xxxxxxXXXXXX-------xxxxxxxxxxxxxxxxx--xxxxxx--xxxxxxxx-----XX---[]---xxxxx----xxxxxxxxxxxxxxxxxxxxxxxxxxxxxxxxxxxxxxxxxxxxxxxxxxxxxxxxxxxxxxxxxxxxxxxxxxx----x
XXXXXXXXXXXX-------XXXXXXXXXXXXXXXXXX-XXXXXXX--XXXXXXXX-----XXX--[]XXXXXXXXXXXXXXXXXXXXXXXXXXXXXXXXXXXXXXXXXXXXXXXXXXXXXXXXXXXXXXXXXXXXXXXXXXXXXXXXXXXXXXX---XX
