---------------------------------------------------------------------------------------------------------------------------------------------------------------
---------------------------------------------------------------------------------------------------------------------------------------------------------------
---------------------------------------------------------------------------------------------------------------------------------------------------------------
---------------------------------------------------------------------------------------------------------------------------------------------------------------
-----------------------------------------------------------------------SSSSSSSSS-----------------------------------------------------------------E-------------
---------------------------------------------------------------------------------------------------------------------------------------------------------------
----------------------------------------------------------------------------------XXX------------------------------------------------------XXXXXEXXXXX---------
--------------------------------------------------------------------------------------------------------Q-Q----------------------------------------------------
-------------------------------------------------------E------------------------------------------------------------------------------------xxxxx--------------
-------------------------------------------------------------------------------------------------------------------------------------xxxxxxxx----xxxxxxxx------
----------------------oo------------------------E----------------------------xxxxx-----SSSSSSSS-----------------oo------------------xx-XXXXXXEXEEXXXXXXX-x-----
-------------------------xxx-------------------<>--------------------SSS----xxXXX-xxxx------------------Q-Q-----------------S------xx---------------------x----
------------------------xxX-x----------------------------------------------xxEXXX-XXX-x--------------------------------------------x-----------------------x---
---------------xxx-----xx-X--x----xxx----------------------------B--------xxXXXXX------x------------------------------------------xx------------------------xxx
-xxxxxxxxxxxxxxx--xxxxxx--X---xxxxx-Exxxxxxxxxxxxxxxxxx-xxxxxxxxxxxxxxxxxxxXXXXXX-------xxxxxxxxxxxxxxxxxxxxxxxxxxxxxxxxxxxxxxxxxxx--------------------XXXXXXXX
XXXXXXXXXXXXXXXX--XXXXXXXXXXXXXXXXX--XXXXXXXXXXXXXXXXXXxXXXXXXXXXXXXXXXXXXXXXXXX-------XXXXXXXXXXXXXXXXXXXXXXXXXXXXXXXXXXXXXXXXXXXX----------------------------
