---------------------------------------------------------------------------------------------------------------------------------------------------------------
---------------------------------------------------------------------------------------------------------------------------------------------------------------
---------------------------------------------------------------------------------------------------------------------------------------------------------------
---------------------------------------------------------------------------------------------------------------------------------------------------------------
---------------------------------------------------------------------------------------------------------------------------------------------------------------
---------------------------------------------------------------------------------------------------------------------------------------------------------------
--------------------------------------------------------------------E------------------------------------------------------------------------------------------
--------------xxxxS-------SSS---------------------------XSSSSS----QQQQQQQ--------------------------------------------------------------------------------------
-------------xx--xxx------------------------------------X------------------------------------------------------------------------------------------------------
------------xx------x-xxx------------S------------------X------------------------------------------------------------------------------------------------------
-----------xx----E-EExx--xx--------X-------------------EX--E-X-------E------------E----------------------------------------------------------------------------
----------xxX--------XX-XX-x-------XSS------------------XSS?SX---QQQQQQQQ----------QQ?QQ-----------------------------------------------------------------------
---------xxXXX-------XX-XX--x--------------------------------------------------E------------------------xxx----------------------------------------------------
--------xxXXXX-------XX-XXX--x----------------B--------------------------------------------------------xxB-x----xxx-xxx----------------------------------------
-xxxxxxxxXXXX--------X--XXX--Exxxxxxxxxxxxxxxxxxxxxxxxxxxxxxxxxxxxxxxxxxxxxxxxxxxxxxxxxxxxxxxxxxxxxxxxxx-b--xxxxx--xx--xxxxxxxxxxxxxxxxxxxxxxxxxxxxxxxxxxxxxxxx
XXXXXXXXXXXXX--------X--XXXXXXXXXXXXXXXXXXXXXXXXXXXXXXXXXXXXXXXXXXXXXXXXXXXXXXXXXXXXXXXXXXXXXXXXXXXXXXXXXXXXXXXXX--XX--XXXXXXXXXXXXXXXXXXXXXXXXXXXXXXXXXXXXXXXX
