------------------------------------------------------------------------------------------------------------------------------------------------------------------
------------------------------------------------------------------------------------------------------------------------------------------------------------------
------------------------------------------------------------------------------------------------------------------------------------------------------------------
------------------------------------------------------------------------------------------------------------------------------------------------------------------
------------------------------------------------------------------------------------------------------------------------------------------------------------------
---------------------------------------------------------------------------------------------------------xxxx-----------------------------------------------------
--------------------------------------------------------------------------------------------------------xx---x----------------------------------------------------
-----------------------------------SQSS-SSSS----SSSSSSQS---Q?SSSS?QQX-----------------------------------x-----xxxx-------------------------------------SE---------
--------------------------------------------------------------------X--------------------------------xxxE------x--x------------------------------------S>---------
-------------------?------------------------------------------------X-------------------------------xx-<>------X---x-----------------------------------[]---------
-----------E----------------------------------------------E---------X------------------------------xx--[]-----XX----x---------------Q------------------XXX--------
----------<>-------------------Q----Q-------------E---QQQQQQQQQQQQQQX-----------------------------xxE--[]-----XX-----x-------SS------------------------X----------
-----B---------------------------B-------------------------------------------------------xxxxxx--xx<>--[]----XXX------x---------------------------B---------------
-----b---------------------------b-------xxxxx---------------------------------------xxxxx<>XX-xxx-[]--[]---XXXX-------x------------xxxxx-----xxx-b-----------xxx-
-xxxxxxxxxxxxxxxxxxxxxxxxxxxxxxxxxxxxxxxxx----xxxxxxxxxxxxxxxxxxxxxxxxxxxxxxxxxxxxxxxxXXXX[]XXXXXXXXXX-[XX-XXXXX--------xxxxxxxxxxxxx----xxxxxxE-xxxxxxxxxxxxxx--x
XXXXXXXXXXXXXXXXXXXXXXXXXXXXXXXXXXXXXXXXXX---XXXXXXXXXXXXXXXXXXXXXXXXXXXXXXXXXXXXXXXXXXXXXXXXXXXXXXXXX-XXX-XXXXXXXXXXXXXXXXXXXXXXXXXX----XXXXXXXXXXXXXXXXXXXXXX--X
