---------------------------------------------------------------------------------------------------------------------------------------------------------------
---------------------------------------------------------------------------------------------------------------------------------------------------------------
---------------------------------------------------------------------------------------------------------------------------------------------------------------
---------------------------------------------------------------------------------------------------------------------------------------------------------------
---SSSSSSSSSSSSSSSSSSSSSSSSSSSSSSSSSSSSSSSSSSSSSSSSSSSSSSSS?SSSSSSSSSSSSSSSSSSSSSSSSSSSSSS?SSSSSSSSSSSSS-------------------------------------------------------
---------------------------------------------------------------------------------------------------SSSSS-------------------------------------------------------
---------------------------------------------------------------------------------------------------SSSSS-------------------------------------------------------
-------------------------------------oooo-oooo-ooooooooooooo---------------------------------------SSSSS-------------------------X-----------------------------
--------------------------o---------------------------------------------------------------xxxxx----SSSSS-------------------------------------------------------
----------------------xxxxx--------S-SSSS-SSSS-SSSSSSSSSSSSS-----------------------xxxxxxxx----x---SSSSS-------------------------------------------------------
------------------xxxxx--S-x-------SoS--SoS--SoSSSSSSSSSSSSS----------------------xxXXXXXXX-----xx-SSSSS---xxxx-----------------------------------------------x
------QQQQQ-----xxxXXXX-----xx-----SSS--SSS--SSS--------------------------xxxx---xxXXXXXXXX----<>-x---SS--xx<>-x----SSQS--------------SS-------?----QQQQ-----xx
--------------xxxXXXXXXXX--XX-xx----------------------------------E-----Exx---x-xxXXXXXXXXX----[]--x--SS-xx-[]--xx-------------------------------B----------xxX
------------xxxXXXXXXXXXX--XXXX-x---------------------------------------xx-----xxXXXXXXXXXX----[]---x-SSxx--[]-<>-x------------------------------b---------xxXX
-xxxxxxxxxxxxXXXXXXXXXXXXE-XXXX--xxxxxxxxxxxxxxxxxxxxxxxxxxxxxxxxxxxxxxxxX-----XXXXXXXXXXXX----[]----xxxx---[]-[]--xxxxxxxxxxxxxxxxxxxxxxxxxxxxxxxxxxxxxxxxxXXX
XXXXXXXXXXXXXXXXXXXXXXXXXXXXXXXXXXXXXXXXXXXXXXXXXXXXXXXXXXXXXXXXXXXXXXXXXX-----XXXXXXXXXXXX--XXXXXXXXXXXXXXXXXXXXXXXXXXXXXXXXXXXXXXXXXXXXXXXXXXXXXXXXXXXXXXXXXX
