---------------------------------------------------------------------------------------------------------------------------------------------------------------
---------------------------------------------------------------------------------------------------------------------------------------------------------------
---------------------------------------------------------------------------------------------------------------------------------------------------------------
---------------------------------------------------------------------------------------------------------------------------------------------------------------
---SSSSSSSSSSSSSSSSSSSSSSSSSSSSSSSSSSSSSSSSSSSSSSSSSSSSSSSSSSSSSSSSSSS?SSSSSSSSSSSSSSSSSSSSSS------------------------------------------------------------------
---------SS-SS--SSSS------SSSSSSSSSSSS--SSSS------SSSS---------------------------------------------------------------------------------------------------------
---------SS-SS--SSSS--E---SSSSSSSSSSSS--SSSS--E---SSSS-----------------------------------------XXX-------------------------------------------------------------
-------SS---SS---S----SS---S--------SS---S----SS----------ooooooooooooo------------------------------------------XXXXXXXXXXX-----------------------------------
-------SS---SS---S----SS---S--------SS---S----SS---------------------------------------------------------------------------------------------------------------
-------SS---SS---S----SS---S--------SS---S----SS----------SSSSSSSSSSSSS----------------------------------------------------------------------------------------
-------SS---SS---So??-SS---SooooooooSS---So??-SS---E------SSSSSSSSSSSSS-------------------xxxxx-----SSSSSSSS---------------------------------------------------
-------SSSS-SS---SSS--SS---SSSSSSSSSSS---SSS--SS--SSSS-----------------------------------xxXXX-xxxx------------------------------------------------------------
---------SS--------------------------------------EE-------------------------------------xxEXXX-XXX-x-----------------------------------------------------------
---------SS------------------------------------------xxxxx-----------------------------xxXXXXX------x------------xxx-xxx-xxx-----------------------------------
-xxxxxxxxxxxxxxxxxxxxxxxxxxxxxxxxxxxxxxxxxxxxxxxxxxxxx----xxxxxxxxxxxxxxxxxxxxxxxxxxxxxxXXXXXX-------xxxxxxxxxxxxx--xx--xx--xxxxxxxxxxxxxxxxxxxxxxxxxxxxxxxxxxx
XXXXXXXXXXXXXXXXXXXXXXXXXXXXXXXXXXXXXXXXXXXXXXXXXXXXXX---XXXXXXXXXXXXXXXXXXXXXXXXXXXXXXXXXXXX-------XXXXXXXXXXXXXX--XX--XX--XXXXXXXXXXXXXXXXXXXXXXXXXXXXXXXXXXX
