---------------------------------------------------------------------------------------------------------------------------------------------------------------
---------------------------------------------------------------------------------------------------------------------------------------------------------------
---------------------------------------------------------------------------------------------------------------------------------------------------------------
---------------------------------------------------------------------------------------------------------------------------------------------------------------
-----------------------xx--------------------------------------------------------------------------------------------------------------------------------------
----------------------xx-x--------------------------------------------------------------------------------------------------------------o----------------------
---------------------xx---x------------------------------------------------------------------------------------------------------------------------------------
-----XXX---------xxxxx-----x---------SSSSS--------------------------------------------?SS---------------------------------------------SSS-------E---------SSSSS
----------------xxXSSS------x------------------------------------------------------------------------------------------------------------------<>--------------
---------------xxXXX---------x-----------------------------------------------------------------------------------------------------xxxxxxxxx---[]--------------
--------------xxXXXS----------xxx------------------------------------------------------------------------------------------------xxx---x----xx-XXX---------E---
-------------xx-XXXX----------<>-x-QQQQ--QQQ------------------xxx--------------------------------E--S---------------------------xx<>---S---<>-x-----------SSSSS
------------xxXXXXXX-SSS------[]--x---------------------------xB-x-------------E---E---B--------<>-----------------------------xx-[]-------[]--x-xxxxxx--------
-----------xxXXXXXXX----------[]---x-------------------------xxb--x--------------------b---------------------------xxx--------xx--[]-------[]---xx<><>-x-------
-xxxxxxxxxxx----XXXX----------[]----xxxxxxxxxxxxxxxxxxxxxxxxxx-BEE-xxxxxxxxxxxxxxxxxxxxxxxxxxxxxxxxxxxxxxxxxxxxxxxxxE-xxxxxxxxx---[]----E--[]----x[][]--xxxxxxx
XXXXXXXXXXXXXXXXXXXXXX---XXXXXXXXXXXXXXXXXXXXXXXXXXXXXXXXXXXXXXXXXXXXXXXXXXXXXXXXXXXXXXXXXXXXXXXXXXXXXX<>XXXXXXXXXXXXXXXXXXXXXXXXXXXXXXXXXXXXXXXXXXXXXXXXXXXXXX
