------------------------------------------------------------------------------------------------------------------------------------------------------------------
------------------------------------------------------------------------------------------------------------------------------------------------------------------
-----------------------------------------------------------------------------------------------------------------------------------------------------------xxx----
----------------------------------------------------------------------------------------------------------------------------------------------------------xx--x---
---------------------------------------------------------------------------------------------------------------------------------------------------------xx----x--
---------------------------------------------------------xxx--------------------------------------------------------------------------------------------xx------xx
-------------------------------------------------------xxx--x-----------------------------------------------------------------------------------------xxx-------XX
------------------------------------------------------xxXX---x------------E------?--QQQQQQQQ------------------EXXXXX---------------------------------xxXX------X--
----------------xxxxxxxx---------XX--o---------------xxXXX----x----------<>-------------------------------------------------------------------------xxXXX---------
---------------xx-------x------------XX-------------xxXXXX-----x---------[]------------------------------------------------------------------------xxXXXX---------
--------------xx---------xxxxxxx-------------------xxXXXXX------x--------[]------------E----------------------------------------------------------xxXXXXX---------
------xxxxx--xx---------XXXXXXX-x-----------------xxXXXXXX-------x------QQXQ-----Q---QQQQQQQ------------------------------------QQQS-------------xxXXXXXX---------
-----xxXXX-xxx-------------------x---------------xxXXXXXXX--------x-------------------------------------E--------------------------------E-----xxxXXXXXXX---------
----xxXXXXXX<>--------------------x-------------xxXXXXXXXX---------x------------------------------------------------------xxxx----------------xxXXXXXXXXX---------
-xxxxXXXXXXX[]---------------------xxxxxxxxxxxxxxXXXXXXXXXXX--------xxxxxxxxxxxxxxxxxxxxxxxxxxxxxxxxxxxxxxxxxxxxxxxxxxxxxxx-E-xxxxxxxxxxxxxxxxxXXXXXXXXXX---------
XXXXXXXXXXXX[]--------------------XXXXXXXXXXXXXXXXXXXXXXXX--XXXXXXXXXXXXXXXXXXXXXXXXXXXXXXXXXXXXXXXXXXXXXXXXXXXXXXXXXXXXXXX-XXXXXXXXXXXXXXXXXXXXXXXXXXXXX---------
