---------------------------------------------------------------------------------------------------------------------------------------------------------------
---------------------------------------------------------------------------------------------------------------------------------------------------------------
---------------------------------------------------------------------------------------------------------------------------------------------------------------
---------------------------------------------------------------------------------------------------------------------------------------------------------------
---------------------------------------------------------------------------------------------------------------------------------------------------------------
---------------------------------------------------------------------------------------------------------------------------------------------------------------
----------------------------------------------------------------------------------------------------------------------------------------------------------XX---
-------------------------------------------------------SS-------------------------xxx---XX--------------SS-----------------------------------------------------
---------------------------------------------------------------------------------xx--xx-----------------------------------------------------------------E------
---------------------------------------------------------------o----------------xx---X-x------------------------o-----------------------------------XXXXXX-----
-----------E-----------------------------------------xxxxxx--------------------xx-E--X--x-------------xxxxxx----------------------------------------xxxxx----XX
------------------Q-------------------------------xxxxXXXX-xSSS---------------xx--X--X---x---------xxxxXXXX-xSSS-------------------xxxxx-------xxxxxx----x-----
--------------------------xxxx-----------------xxxxXXXXX----x----------------xxE--X--X----x-----xxxxXXXXX----x---------xxx--------xx----x-----xxXXXXX-----x----
-------------------------xx<>-x---xxxxx-----xxxxXXXXXX-------x--------------xx-X--X--X-----x-xxxxXXXXXX-------x-------xx--x------xxX---X-x---xx------------x--x
-xxxxxxxxxxxxxxxxxxxxxxxxx-[]--xxxx----xxxxxxXXXXXXX----------xxxxxxxxxxxxxxx--X--X--X------xxXXXXXXX----------xxxxxxxxX---xxxxxxx-X-E-X--xxxx--------------xxx
XXXXXXXXXXXXXXXXXXXXXXXXXXXXXXXXXXX----XXXXXXXXXXX------XX--XXXXXXXXXXXXXXXXX--X--X--X-----XXXXXXXX------XX--XXXXXXXXXXX---XXXXXXXXXXXXXXXXXXX--------------XXX
