------------------------------------------------------------------------------------------------------------------------------------------------------------------
------------------------------------------------------------------------------------------------------------------------------------------------------------------
------------------------------------------------------------------------------------------------------------------------------------------------------------------
-----------------------------------------------------------------------------------SS-----------------------------------------------------------------------------
-----------------------------------------------------------------------------------[]-----------------------------------------------------------------------------
-----------------------------------------------------------------------------------[]------------------XX---------------------------------------------------------
-----------------------------------------------------------------------------------<>S---------------EXX----------------------------------------------------------
-----------------------------------------SSSQS-------------E------------------------<----------------XXX--------------<>------------------------------------------
----------------------------------------------------------------------------------------------------XXXX----------<>--[]------------------------------------------
---------------------------xxx-----------------------------------------------Q---xxxE--------------XXXXX----------[]--[]-----------------------<E-----E-------<E--
--------xxxx-Q--Q--------xxx--x---------------------o---------------------------xx<>E-------<>----XXXXXX------E---XX--[]-----------------------[>----<>-------[>--
----Q--xx<>-x--Q--------xxXX---x------------SSSSSE---Q-------------------------xx-[]----<>--[]---XXXXXXX-E--------XX--[]---E--<>-------<>------[]----[]----E--[]--
------xx-[]--x---------xxXXX----x---------------------------------------------xx--[]----[]--[]--XXXXXXXX->------------[]--<>--[]---<>--[]--E---[]----[]---<>--[]--
-----xx--[]---x-------xxXXXX-----x----------------------xxxxxxxx-xxxxxxxxxxxxxx---[]-X--[]--[XXXXXXXXXXX<]-------?----[X--[]--[]---[]--[]-<>---[]----[]---[]--[XXX
-xxxxx---[]----xxxxxxxxXXXXX------xxxxxxxxxxxxxxxxxxxxxxx----x--xx----x--XXXXXXXXXXXXXXXXX--XXXXXXXXXXXX[]------------XX--[]--[X---[]--XX-[]---XXXXXXXXXXX[]--XXXX
XXXXXXXXXXXXXXXXXXXXXXXXXXXX------XXXXXXXXXXXXXXXXXXXXXXX---XX--XX-XXXX--XXXXXXXXXXXXXXXXX--XXXXXXXXXXXX[]XXXXXXXXXX--XX--XX--XX--XXX--XX-XX---XXXXXXXXXXXXX--XXXX
