---------------------------------------------------------------------------------------------------------------------------------------------------------------
---------------------------------------------------------------------------------------------------------------------------------------------------------------
---------------------------------------------------------------------------------------------------------------------------------------------------------------
-------------------------------------------------------------------------------------------------------------------------------------------------------E-------
---------------------------------------------------------------------------------------------------------------------------------------------------------------
---------------------------------------------------------------------------------------------------------------------------------------------------------------
-----------------------------------------------------------------------------------------------------------------------------------------------SSSSSSSS?S------
----------------------------------------------------------------------------------------------------------------S-------------------------------[]-------------
------------------------------------------------------------------------------------------------------------------------------------------------[]-------------
------------------------------------------------------------------------------------------------------------------------------------------------[]-------------
------------------------------------------------------------------------ooo---------------------------------------------------------------------[]-------------
----------------------------------------Q-------------------------------------------E----------------QQ-------QQQQ------------------------------<>------------x
--------------------------------------------------------------------------------E---------------------------------------------------------------xxx----------xx
-------------------------------------B-----------------------xxx-------------------------B-----xxx------xxx-----------------------xxxxxxxxxxxxxxxE-xxxxxxxxxxx-
-xxxxxxxxxxxxxxxxxxxxxxxxxxxxxxxxxxxxxxxxxxxxxxxxxxxxxxxxxxxxx--xxxxxxxxxxxxxxxxxxxxxxxxxxxxxxxx--xxxxxxx--xxxxxxxxxxxxxxxxxxxxxxxxEXXEXXXXXXXXXXXXXXXXXXXXXXXX
XXXXXXXXXXXXXXXXXXXXXXXXXXXXXXXXXXXXXXXXXXXXXXXXXXXXXXXXXXXXXX--XXXXXXXXXXXXXXXXXXXXXXXXXXXXXXXX--XXXXXXX--XXXXXXXXXXXXXXXXXXXXXXXXXXXXXXXXXXXXXXXXXXXXXXXXXXXX
