---------------------------------------------------------------------------------------------------------------------------------------------------------------
---------------------------------------------------------------------------------------------------------------------------------------------------------------
---------------------------------------------------------------------------------------------------------------------------------------------------------------
---------------------------------------------------------------------------------------------------------------------------------------------------------------
---------------------------------------------------------------------------------------------------------------------------------------------------------------
---------------------------------------------------------------------------------------------------------------------------------------------------------------
---------------------------------------------------o-o-----------------------------------------------------------------------XXX----ooo-----------------o-o----
----------------------------------------------XXX-------------------------------------------------------------XXXXXXXXXXX------------------XX-E----XXX---------
-------------------------------------------------------------------------------------------XXXoo---------------------------------------------------------------
--------------------------------------------------------------------------------------------------X------------------------------------------------------------
---------------------------------------------------------------------------------------------------------------------------------------------------------------
---------------------------XXXX---XXXX---XXX-------XXX---------------------------XXXX-------------------------------------------------------------------XXX----
---------------------------------------------------------------------------------------------------------------------------------------------------------------
------xxx-xxx-----------------------------------------------------------?--------------------------------------------------------------------------------------
-xxxxxx--xx---------------------------------------------------------E----------------------------------------------------E-------------------------------------
XXXXXXX--XX--XXXXX-XXXXXX-------X------------------------XXXXXXXXXXXXXXX-XXXXXX---------------------------XXXXXXXXXXXXXXXXXXX---------XXXXXXXXXXXXX-----------X
