------------------------------------------------------------------------------------------------------------------------------------------------------------------
------------------------------------------------------------------------------------------------------------------------------------------------------------------
------------------------------------------------------------------------------------------------------------------------------------------------------------------
------------------------------------------------------------------------------------------------------------------------------------------------------------------
------------------------------------------------------------------------------------------------------------------------------------------------------------------
-----------------------------------------------------------------------------------------------------xxx----------------------------------------------------------
----------------------------------------------------------------------------------------------------xx--x---------------------------------------------------------
-------------------------------xxx----SSS--xxxxx-SSSSSSSSSSXXX------SSSSS-------------------------xxx----x-------------xxxx---------------------------------------
------------------------------xx--x-------xxx-S-x------------------------------------------------xxXX-----x-----------xxXX-x--------------------------------------
-----------------------------xx----xxxxxxxx------x----------------------------------------------xxXXX------x---------xxXXX--x-------------------------------------
-----------oo---------------xx-----x---x--S-------x--------------------------------------------xxEXXX-------x-------xxXXXX---x--------S---------S-SE--------------
----------------?---------xxx-----<>---S-----------x---------------QQSSSS----------------xxxxxxxXXXXX--------x-----xxXXXXX----x------------------S-----------xxxx-
-------------------------xx<>-----[]-------x--------x-------------------------<>xxxx--xxxxxxxxxXXXXXX---------x---xxXXXXXX-----x------------xxxxx-----------xx<>-x
---------xxxxx---xxxxx--xx-[]-----[]-----------------xx--------------xxx-------xx<>-xxxXXXXXXXEXXXXXX----------x-xxXXXXXXX------x----------xxXXXXxxxxxxxxxxxx-[]--
-xxxxxxxxx----xxxxBEEExxx--[]-----[]--E--------------X-xxxxxxxxxxxxxxx--xxxxxxxx-[]--xXXXXXXXXXXXXXXX-----------xxXXXXXXXX-------xxxxxxxxxxxXXXXXXXXXXXXXXXXXXXXXX
XXXXXXXXXX----XXXXXXXXXXXXXXXXXXXXXXXXXXXXX----------XXXXXXXXXXXXXXXXX--XXXXXXXXXXXXXXXXXXXXXXXXXXXXX---XXXXXXXXXXXXXXXXXXXXXXXXXXXXXXXXXXXXXXX-XXXXXXXXXXXXXXXXXX
