---------------------------------------------------------------------------------------------------------------------------------------------------------------
---------------------------------------------------------------------------------------------------------------------------------------------------------------
----------------------------------------------------------xxx--------------------------------------------------------------------------------------------------
------------------------------xxxxxxxxxxxxxxxxxxxxxxxxxxxxx--x-------------------------------------------------------------------------------------------------
------------------------------xXXXXXXXXXXXXXXXXXXXXXXXXXXXX---x------------------------------------------------------------------------------------------------
-----------------------------xxXXXXXXXXXXXXXXXXXXXXXXXXXXXX----x-----------------------------------------------------------------------------------------------
----------------------------xx-XXXXXXXXXXXXXXXXXXXXXXXXXXXX-----x---------------------------------------------------------------------------------oo-----------
----------------------------xS-XXXXXXXXXXXXXXXXXXXXXXXXXXXX------x---------------------------------------------------------------------------------------------
----------------------------x--XXXXXXXXXXXXXXXXXXXXXXXXXXXX-------x------------------------------------oooo----------------------------------------------------
---------------------------xx--XXXXXXXXXXXXXXXXXXXXXXXXXXXX--------x-------------------------------------------------------------------------------------------
--------------------------xxS--XXXXXXXXXXXXXXXXXXXXXXXXXXXX---------x------------------------------xxxx-------------------------------------xxxx---------------
-----------------SSQS-----x----XXXXXXXXXXXXXXXXXXXXXXXXXXXX----------x-------------------QQQ------xx<>-x-----------------------XQQ?QQ------xx<>-x-----------Q--
-----------xxxx----------xx----XXXXXXXXXXXXXXXXXXXXXXXXXXXX-----------x--------------------------xx-[]--x---------------------------------xx-[]--x-------------
----------xx<>-x--------xx---E-XXXXXXXXXXXXXXXXXXXXXXXXXXXX------------x-----xxxxx--------------xx--[]---x-------------------------------xx--[]---x------------
-xxxxxxxxxx-[]--xxxxxxxxx------XXXXXXXXXXXXXXXXXXXXXXXXXXXX-----------X-xxxxxx----xxxxxxxxxxxxxxx---[]----xxxxxxxxxxxxxxxxxxxxxxxxxxxxxxxx---[]-E-Exxxxxxxxxxxx
XXXXXXXXXXXXXXXXXXXXXXXXXXXXXXXXXXXXXXXXXXXXXXXXXXXXXXXXXXX--XXXXXXXXXXXXXXXXX----XXXXXXXXXXX<>XXXXXXXXXXXXXXXXXXXXXXXXXXXXXXXXXXXXXXX<>XXXXXXXXXXXXXXXXXXXXXXX
