------------------------------------------------------------------------------------------------------------------------------------------------------------------
------------------------------------------------------------------------------------------------------------------------------------------------------------------
----------------------------------------------------------------------------------------------------xx---------------xxx------------------------------------------
---------------------------------------------------------------------------------------------------x--x-------------xx--x-----------------------------------------
--------------------------------------------------------------------------------------------------xx---x-----xxx---xx----x-----------S----------------------------
-------------------------------------------------------------------------------------------------xx---X-xxxxxx--x-xx------x---------------------------------------
---------------------------------------------------------------------------ooo-------------------x------XXXXXX---xx--------xxxxxx-------------------ooooo---------
-------------QSS-------------------------------------SSSSSSS-------------SSSS-------------------xE-----XX--------XX--------XXXXX-xoo------xxxxxxxx--XXXXXXXX------
------------------------------------------------E-----------------------------------------------x>--------------------------------x-xxxxxxx----x--x---------------
----------------------------------------------------------------------xxxx------------------xxxx<]---------------------------------xx-XXXXX----X---x--------------
------------------------------------------------SSSSS---------------xxx---x------Q--------xxx---[]---------------------------------XX---------------x-------------
----------QQQQSSSSSS----------------------S?S?SS-----------QQQ-----xx<>----x-------------xx<>---[]---------------------------------------------------x------------
------------------------------------------------------E-----------xx-[]-----x-----------xx-[]---[]------------------------X---------------------------x-----------
-------------xxx-------------------------------------------------xx--[]------x---------xx--[]---[]X----------------------------------------------------x-xxx-----x
-xxxxxxxxxxxxx--xxxxxxxxxxxxxxxxxxxxxxxxxxxxxxxxxxxxxxxxxxxxxxxxxx---[]------Exxxxxxxxxx---[]---[XXX-----------------XXX-------------------------------Exx--xxxxxx
XXXXXXXXXXXXXX--XXXXXXXXXXXXXXXXXXXXXXXXXXXXXXXXXXXXXXXXXXXXXXXXXXXXXXXXXXXXXXXXXXXXXXXXXXXXXX--XXXXX--------------------------------------------XXXXXXXXX--XXXXXX
